21,21,21,21,21,21,21,21,21,21,21,21,21,21,21,21,21,21,21,21,21,21,21,21,21
10,12,30,31,31,30,31,31,31,31,30,31,31,31,31,32,31,31,31,31,32,31,32,10,12
10,12,40,41,41,40,41,41,41,41,40,41,41,41,41,42,41,41,41,41,42,41,42,10,12
10,12,50,51,51,50,51,51,51,51,50,51,51,51,51,52,51,51,51,51,52,51,52,10,12
10,12,3,4,5,3,4,5,3,4,5,3,4,5,3,4,5,3,4,5,3,4,5,10,12
10,12,13,14,15,0,1,2,13,14,15,0,1,2,13,14,15,0,1,2,13,14,15,10,12
10,12,23,24,25,10,11,12,23,24,25,10,11,12,23,24,25,10,11,12,23,24,25,10,12
10,12,3,4,5,20,21,22,3,4,5,20,21,22,3,4,5,20,21,22,3,4,5,10,12
10,12,13,14,15,30,31,32,13,14,15,30,31,32,13,14,15,30,31,32,13,14,15,10,12
10,12,23,24,25,40,41,42,23,24,25,40,41,42,23,24,25,40,41,42,23,24,25,10,12
10,12,3,4,5,50,51,52,3,4,5,50,51,52,3,4,5,50,51,52,3,4,5,10,12
10,12,13,14,15,15,13,14,13,14,15,13,14,15,13,14,15,13,14,15,13,14,15,10,12
10,12,23,24,25,0,1,2,23,24,25,0,1,2,23,24,25,0,1,2,23,24,25,10,12
10,12,3,4,5,10,11,12,3,4,5,10,11,12,3,4,5,10,11,12,3,4,5,10,12
10,12,13,14,15,20,21,22,13,14,15,20,21,22,13,14,15,20,21,22,13,14,15,10,12
10,12,23,24,25,30,31,32,23,24,25,30,31,32,23,24,25,30,31,32,23,24,25,10,12
10,12,3,4,5,40,41,42,3,4,5,40,41,42,3,4,5,40,41,42,3,4,5,10,12
10,12,13,14,15,50,51,52,13,14,15,50,51,52,13,14,15,50,51,52,13,14,15,10,12
10,12,3,4,5,3,4,5,3,4,5,3,4,5,3,4,5,3,4,5,3,4,5,10,12
1,1,1,1,1,1,1,1,1,1,1,1,1,1,1,1,1,1,1,1,1,1,1,1,1
