21,21,21,21,21,21,21,21,21,21,21,21,21,21,21,21,21,21,21,21,21,21,21,21,21
10,12,30,31,31,30,31,31,31,31,30,31,31,31,31,32,31,31,31,31,32,31,32,10,12
10,12,40,41,41,40,41,41,41,41,40,41,41,41,41,42,41,41,41,41,42,41,42,10,12
10,12,50,51,51,50,51,51,51,51,50,51,51,51,51,52,51,51,51,51,52,51,52,10,12
10,12,03,04,05,03,04,05,03,04,05,03,04,05,03,04,05,03,04,05,03,04,05,10,12
10,12,13,14,15,13,14,15,13,14,15,13,14,15,13,14,15,13,14,15,13,14,15,10,12
10,12,23,24,25,00,01,02,23,24,25,00,01,02,23,24,25,00,01,02,23,24,25,10,12
10,12,03,04,05,20,21,22,03,04,05,20,21,22,03,04,05,20,21,22,03,04,05,10,12
10,12,13,14,15,30,31,32,13,14,15,30,31,32,13,14,15,30,31,32,13,14,15,10,12
10,12,23,24,25,40,41,42,23,24,25,40,41,42,23,24,25,40,41,42,23,24,25,10,12
10,12,03,04,05,50,51,52,03,04,05,50,51,52,03,04,05,50,51,52,03,04,05,10,12
10,12,13,14,15,03,04,05,13,14,15,03,04,05,13,14,15,03,04,05,13,14,15,10,12
10,12,23,24,25,13,14,15,23,24,25,13,14,15,23,24,25,13,14,15,23,24,25,10,12
10,12,03,04,05,00,01,02,03,04,05,00,01,02,03,04,05,00,01,02,03,04,05,10,12
10,12,13,14,15,20,21,22,13,14,15,20,21,22,13,14,15,20,21,22,13,14,15,10,12
10,12,23,24,25,30,31,32,23,24,25,30,31,32,23,24,25,30,31,32,23,24,25,10,12
10,12,03,04,05,40,41,42,03,04,05,40,41,42,03,04,05,40,41,42,03,04,05,10,12
10,12,03,04,05,50,51,52,03,04,05,50,51,52,03,04,05,50,51,52,03,04,05,10,12
10,12,13,14,15,03,04,05,13,14,15,03,04,05,13,14,15,03,04,05,13,14,15,10,12
10,12,23,24,25,13,14,15,23,24,25,13,14,15,23,24,25,13,14,15,23,24,25,10,12

0,0,0,0,0,0,0,0,0,0,0,0,0,0,0,0,0,0,0,0,0,0,0,0,0
0,0,0,0,0,0,0,0,0,0,0,0,0,0,0,0,0,0,0,0,0,0,0,0,0
0,0,2,2,2,2,2,2,2,2,2,2,2,2,2,2,2,2,2,2,2,2,2,0,0
0,1,1,1,1,1,1,1,1,1,1,1,1,1,1,1,1,1,1,1,1,1,1,1,0
0,1,3,3,4,4,4,4,3,3,4,4,4,4,3,3,4,4,4,4,3,3,4,1,0
0,1,3,3,4,4,4,4,3,3,4,4,4,4,3,3,4,4,4,4,3,3,4,1,0
0,1,3,3,4,1,1,1,3,3,4,1,1,1,3,3,4,1,1,1,3,3,4,1,0
0,1,3,3,4,1,0,1,3,3,4,1,0,1,3,3,4,1,0,1,3,3,4,1,0
0,1,3,3,4,1,0,1,3,3,4,1,0,1,3,3,4,1,0,1,3,3,4,1,0
0,1,3,3,4,1,2,1,3,3,4,1,2,1,3,3,4,1,2,1,3,3,4,1,0
0,1,3,3,4,1,1,1,3,3,4,1,1,1,3,3,4,1,1,1,3,3,4,1,0
0,1,3,3,4,4,4,4,3,3,4,4,4,4,3,3,4,4,4,4,3,3,4,1,0
0,1,3,3,4,4,4,4,3,3,4,4,4,4,3,3,4,4,4,4,3,3,4,1,0
0,1,3,3,4,1,1,1,3,3,4,1,1,1,3,3,4,1,1,1,3,3,4,1,0
0,1,3,3,4,1,0,1,3,3,4,1,0,1,3,3,4,1,0,1,3,3,4,1,0
0,1,3,3,4,1,0,1,3,3,4,1,0,1,3,3,4,1,0,1,3,3,4,1,0
0,1,3,3,4,1,2,1,3,3,4,1,2,1,3,3,4,1,2,1,3,3,4,1,0
0,1,3,3,4,1,1,1,3,3,4,1,1,1,3,3,4,1,1,1,3,3,4,1,0
0,1,4,4,4,4,4,4,4,4,4,4,4,4,4,4,4,4,4,4,4,4,4,1,0
0,1,4,4,4,4,4,4,4,4,4,4,4,4,4,4,4,4,4,4,4,4,4,1,0