30,31,30,31,31,31,30,31,31,30,31,31,30,31,31,31,30,31,31,30,31,31,30,31,32
40,41,40,41,41,41,40,41,41,40,41,41,40,41,41,41,40,41,41,40,41,41,40,41,42
50,51,50,51,51,51,50,51,51,50,51,51,50,51,51,51,50,51,51,50,51,51,50,51,52
03,04,05,03,04,05,03,04,05,03,04,05,03,04,05,03,04,05,03,04,05,03,04,05,03
13,14,15,13,14,15,13,14,15,13,14,15,13,14,15,13,14,15,13,14,15,13,14,15,13
01,01,01,01,01,01,01,01,01,01,01,02,03,04,00,01,01,01,01,01,01,01,01,01,01
21,21,21,21,21,21,21,21,21,21,21,22,13,14,20,21,21,21,21,21,21,21,21,21,21
30,31,32,30,31,32,30,31,32,30,31,32,23,24,30,30,31,30,31,32,30,31,30,31,32
40,41,42,40,41,42,40,41,42,40,41,42,03,04,40,40,41,40,41,42,40,41,40,41,42
50,51,52,50,51,52,50,51,52,50,51,52,13,14,50,50,51,50,51,52,50,51,50,51,52
03,04,05,03,04,05,03,04,05,03,04,05,03,04,05,03,04,05,03,04,05,03,04,05,03
13,14,15,13,14,15,13,14,15,13,14,15,13,14,15,13,14,15,13,14,15,13,14,15,13
23,24,25,23,24,25,23,24,03,04,05,25,23,24,25,03,04,05,23,24,25,23,24,25,23
00,01,02,03,04,05,00,01,02,03,04,05,00,01,02,13,14,15,00,01,02,03,04,05,00
20,21,22,13,14,15,20,21,22,13,14,15,20,21,22,23,24,25,20,21,22,13,14,15,20
30,31,32,23,24,25,30,31,32,23,24,25,30,31,32,03,04,05,30,31,32,23,24,25,30
40,41,42,03,04,05,40,41,42,03,04,05,40,41,42,13,14,15,40,41,42,03,04,05,40
50,51,52,13,14,15,50,51,52,13,14,15,50,51,52,23,24,25,50,51,52,13,14,15,50
03,04,05,03,04,05,03,04,05,23,24,25,03,04,05,03,04,05,03,04,05,23,03,04,05
03,04,05,03,04,05,03,04,05,03,04,03,04,05,04,05,05,03,03,04,05,03,03,04,05

0,0,0,0,0,0,0,0,0,0,0,0,0,0,0,0,0,0,0,0,0,0,0,0,0
2,2,2,2,2,2,2,2,2,2,2,2,2,2,2,2,2,2,2,2,2,2,2,2,2
1,1,1,1,1,1,1,1,1,1,1,1,1,1,1,1,1,1,1,1,1,1,1,1,1
3,3,3,3,3,3,3,3,3,3,3,3,3,3,3,3,3,3,3,3,3,3,3,3,4
4,4,4,4,4,4,4,4,4,4,4,4,3,4,4,4,4,4,4,4,4,4,4,4,4
1,1,1,1,1,1,1,1,1,1,1,1,3,4,1,1,1,1,1,1,1,1,1,1,1
0,0,0,0,0,0,0,0,0,0,0,1,3,4,1,0,0,0,0,0,0,0,0,0,0
0,0,0,0,0,0,0,0,0,0,0,1,3,4,1,0,0,0,0,0,0,0,0,0,0
2,2,2,2,2,2,2,2,2,2,2,1,3,4,1,2,2,2,2,2,2,2,2,2,2
1,1,1,1,1,1,1,1,1,1,1,1,3,4,1,1,1,1,1,1,1,1,1,1,1
3,3,3,3,3,3,3,3,3,3,3,3,3,4,4,3,3,3,3,3,3,3,3,3,4
3,3,3,3,3,3,3,3,3,3,3,3,3,3,3,3,3,3,3,3,3,3,3,3,4
4,4,4,3,3,4,4,4,4,3,3,4,4,4,4,3,3,4,4,4,4,3,3,4,4
1,1,1,3,3,4,1,1,1,3,3,4,1,1,1,3,3,4,1,1,1,3,3,4,1
1,0,1,3,3,4,1,0,1,3,3,4,1,0,1,3,3,4,1,0,1,3,3,4,1
1,0,1,3,3,4,1,0,1,3,3,4,1,0,1,3,3,4,1,0,1,3,3,4,1
1,2,1,3,3,4,1,2,1,3,3,4,1,2,1,3,3,4,1,2,1,3,3,4,1
1,1,1,3,3,4,1,1,1,3,3,4,1,1,1,3,3,4,1,1,1,3,3,4,1
3,3,3,3,3,3,3,3,3,3,3,3,3,3,3,3,3,3,3,3,3,3,3,3,4
4,4,4,4,4,4,4,4,4,4,4,4,4,4,4,4,4,4,4,4,4,4,4,4,4