21,21,21,21,21,21,21,21,21,21,21,21,21,21,21,21,21,21,21,21,21,21,21,21,00
10,12,32,30,31,32,30,31,32,30,31,32,30,31,32,30,31,32,30,31,32,30,31,32,10
10,12,42,40,41,42,40,41,42,40,41,42,40,41,42,40,41,42,40,41,42,40,41,42,10
10,12,52,50,51,52,50,51,52,50,51,52,50,51,52,50,51,52,50,51,52,50,51,52,10
10,12,03,04,05,03,04,05,03,04,05,03,04,05,03,04,50,03,04,05,03,03,04,05,10
10,12,13,14,15,13,14,15,13,14,15,13,14,15,13,14,15,13,14,15,13,13,14,15,10
01,01,01,01,01,01,01,01,01,01,01,01,01,01,01,01,01,01,01,01,02,23,24,25,10
21,21,21,21,21,21,21,21,21,21,21,21,21,21,21,21,21,21,21,21,22,03,04,05,10
30,31,32,30,31,32,30,31,32,30,31,32,30,31,32,30,31,32,30,31,32,13,14,15,10
40,41,42,40,41,42,40,41,42,40,41,42,40,41,42,40,41,42,40,41,42,23,24,25,10
50,51,52,50,51,52,50,51,52,50,51,52,50,51,52,50,51,52,50,51,52,03,04,05,10
03,04,05,03,04,05,03,04,05,03,04,05,03,04,05,03,04,05,03,04,05,13,14,15,10
13,14,15,13,14,15,13,14,15,13,14,15,13,14,15,13,14,15,13,14,15,23,24,25,10
23,24,25,00,01,01,01,01,01,01,01,01,01,01,01,01,01,01,01,01,01,01,01,01,01
03,04,05,20,21,21,21,21,21,21,21,21,21,21,21,21,21,21,21,21,21,21,21,21,21
13,14,15,30,31,32,30,31,32,30,31,32,30,31,32,30,31,32,30,31,32,30,31,10,12
23,24,25,40,41,42,40,41,42,40,41,42,40,41,42,40,41,42,40,41,42,40,41,10,12
03,04,05,50,51,52,50,51,52,50,51,52,50,51,52,50,51,52,50,51,52,50,51,10,12
13,14,15,13,14,15,13,14,15,13,14,15,13,14,15,13,14,15,13,14,15,13,14,10,12
23,24,25,23,24,25,23,24,25,23,24,25,23,24,25,23,24,25,23,24,25,23,24,10,12

0,0,0,0,0,0,0,0,0,0,0,0,0,0,0,0,0,0,0,0,0,0,0,0,0
0,0,0,0,0,0,0,0,0,0,0,0,0,0,0,0,0,0,0,0,0,0,0,0,0
0,0,2,2,2,2,2,2,2,2,2,2,2,2,2,2,2,2,2,2,2,2,2,2,0
0,1,1,1,1,1,1,1,1,1,1,1,1,1,1,1,1,1,1,1,1,1,1,1,1
0,1,3,3,3,3,3,3,3,3,3,3,3,3,3,3,3,3,3,3,3,3,3,4,1
0,1,4,4,4,4,4,4,4,4,4,4,4,4,4,4,4,4,4,4,4,3,3,4,1
0,1,1,1,1,1,1,1,1,1,1,1,1,1,1,1,1,1,1,1,1,3,3,4,1
0,0,0,0,0,0,0,0,0,0,0,0,0,0,0,0,0,0,0,0,1,3,3,4,1
0,0,0,0,0,0,0,0,0,0,0,0,0,0,0,0,0,0,0,0,1,3,3,4,1
2,2,2,2,2,2,2,2,2,2,2,2,2,2,2,2,2,2,2,2,1,3,3,4,1
1,1,1,1,1,1,1,1,1,1,1,1,1,1,1,1,1,1,1,1,1,3,3,4,1
3,3,3,3,3,3,3,3,3,3,3,3,3,3,3,3,3,3,3,3,3,3,3,4,1
3,3,4,4,4,4,4,4,4,4,4,4,4,4,4,4,4,4,4,4,4,4,4,4,1
3,3,4,1,1,1,1,1,1,1,1,1,1,1,1,1,1,1,1,1,1,1,1,1,1
3,3,4,1,0,0,0,0,0,0,0,0,0,0,0,0,0,0,0,0,0,0,0,0,0
3,3,4,1,0,0,0,0,0,0,0,0,0,0,0,0,0,0,0,0,0,0,0,0,0
3,3,4,1,2,2,2,2,2,2,2,2,2,2,2,2,2,2,2,2,2,2,2,0,0
3,3,4,1,1,1,1,1,1,1,1,1,1,1,1,1,1,1,1,1,1,1,1,1,0
3,3,3,3,3,3,3,3,3,3,3,3,3,3,3,3,3,3,3,3,3,3,4,1,0
4,4,4,4,4,4,4,4,4,4,4,4,4,4,4,4,4,4,4,4,4,4,4,1,0