10,11,12,30,31,32,10,11,11,11,11,12,30,31,32,10,11,11,11,11,12,30,31,31,00
10,11,12,40,41,42,10,11,11,11,11,12,40,41,42,10,11,11,11,11,12,40,41,41,10
20,21,22,50,51,52,20,21,21,21,21,22,50,51,52,20,21,21,21,21,22,50,51,51,20
30,31,32,03,04,05,30,31,31,31,31,32,03,04,05,30,31,31,31,31,32,03,04,05,30
40,41,42,13,14,15,40,41,41,41,41,42,13,14,15,40,41,41,41,41,42,13,14,15,40
50,51,52,23,24,25,50,51,51,51,51,52,23,24,25,50,51,51,51,51,52,23,24,25,50
03,04,05,03,04,05,03,04,05,03,04,05,03,04,05,03,04,05,03,04,05,03,04,05,03
13,14,15,13,14,15,13,14,15,13,14,15,13,14,15,13,14,15,13,14,15,13,14,15,13
23,24,25,23,24,25,23,24,25,23,24,25,23,24,25,23,24,25,23,24,25,23,24,25,23
03,04,05,03,04,05,00,01,01,01,01,01,01,01,01,01,01,01,02,04,05,03,04,05,03
13,14,15,13,14,15,10,11,11,11,11,11,11,11,11,11,11,11,12,14,15,13,14,15,13
23,24,25,23,24,25,10,11,11,00,01,01,01,01,01,02,11,11,12,24,25,23,24,25,23
00,01,02,03,04,05,10,11,12,30,31,31,31,31,31,32,10,11,12,03,04,05,00,01,02
10,11,12,13,14,15,10,11,12,40,41,41,41,41,41,42,10,11,12,13,14,15,10,11,12
20,21,22,23,24,25,20,21,22,50,51,51,51,51,51,52,10,21,22,23,24,25,20,21,22
30,31,32,03,04,05,30,31,31,03,04,05,05,03,04,05,31,31,32,03,04,05,30,31,32
40,41,42,13,14,15,40,41,41,13,14,15,15,13,14,15,41,41,42,13,14,15,40,41,42
50,51,52,23,24,25,50,51,51,23,24,25,25,23,24,25,51,51,52,23,24,25,50,51,52
03,04,05,03,04,05,03,04,05,03,04,05,03,04,05,03,04,05,03,04,05,03,04,05,03
13,14,15,13,14,15,13,14,15,13,14,15,13,14,15,13,14,15,13,14,15,13,14,15,13

1,1,1,1,1,1,1,1,1,1,1,1,1,1,1,1,1,1,1,1,1,1,1,1,1
1,0,0,0,0,0,0,0,0,0,0,0,0,0,0,0,0,0,0,0,0,0,0,0,1
1,0,1,1,1,1,1,0,0,0,0,1,1,1,1,1,0,0,0,0,1,1,1,1,1
1,0,1,4,4,4,1,0,0,0,0,1,4,4,4,1,0,0,0,0,1,4,4,4,1
1,2,1,4,4,4,1,2,2,2,2,1,4,4,4,1,2,2,2,2,1,4,4,4,1
1,1,1,4,4,4,1,1,1,1,1,1,4,4,4,1,1,1,1,1,1,4,4,4,1
4,3,3,3,3,3,3,3,3,3,3,3,3,3,3,3,3,3,3,3,3,3,3,3,4
4,3,3,3,3,3,3,3,3,3,3,3,3,3,3,3,3,3,3,3,3,3,3,3,4
4,3,3,3,3,4,4,4,4,4,4,4,4,4,4,4,4,4,4,3,3,3,3,3,4
4,3,3,3,3,4,1,1,1,1,1,1,1,1,1,1,1,1,1,3,3,3,3,3,4
4,3,3,3,3,4,1,0,0,0,0,0,0,0,0,0,0,0,1,3,3,3,3,3,4
4,4,4,3,3,4,1,0,0,0,0,0,0,0,0,0,0,0,1,3,3,4,4,4,4
1,1,1,3,3,4,1,0,0,0,0,0,0,0,0,0,0,0,1,3,3,4,1,1,1
1,0,1,3,3,4,1,0,0,2,2,2,2,2,2,2,0,0,1,3,3,4,1,0,1
1,0,1,3,3,4,1,0,1,1,1,1,1,1,1,1,1,0,1,3,3,4,1,0,1
1,0,1,3,3,4,1,0,1,4,3,3,3,3,3,4,1,0,1,3,3,4,1,0,1
1,2,1,3,3,4,1,2,1,4,3,3,3,3,3,4,1,2,1,3,3,4,1,2,1
1,1,1,3,3,4,1,1,1,4,3,3,3,3,3,4,1,1,1,3,3,4,1,1,1
4,4,4,3,3,3,3,3,3,3,3,3,3,3,3,3,3,3,3,3,3,4,4,4,4
4,4,4,4,4,4,4,4,4,4,4,4,4,4,4,4,4,4,4,4,4,4,4,4,4